10 10
0 1 1 1 1 1 0 0 0 0
0 1 8 0 1 1 1 0 0 0 
0 1 0 4 0 0 1 0 0 0 
1 1 1 0 1 0 1 1 0 0  
1 2 1 0 1 0 0 1 0 0  
1 2 4 0 0 1 0 1 0 0
1 2 0 0 0 4 0 1 0 0
1 1 1 1 1 1 1 1 0 0
0 0 0 0 0 0 0 0 0 0 
0 0 0 0 0 0 0 0 0 0