10 10
0 0 0 0 0 0 0 0 0 0
0 0 0 1 1 1 0 0 0 0
0 0 0 1 2 1 0 0 0 0
0 0 0 1 0 1 1 1 1 0
0 1 1 1 4 0 4 2 1 0
0 1 2 0 4 8 1 1 1 0
0 1 1 1 1 4 1 0 0 0
0 0 0 0 1 2 1 0 0 0
0 0 0 0 1 1 1 0 0 0
0 0 0 0 0 0 0 0 0 0
