10 10
0 1 1 1 1 1 1 1 0 0
0 1 0 0 0 0 0 1 1 1
1 1 4 1 1 1 0 0 0 1
1 0 0 8 4 0 0 4 0 1
1 0 2 2 1 0 4 0 1 1
1 1 2 2 1 0 0 0 1 0
0 1 1 1 1 1 1 1 1 0
0 0 0 0 0 0 0 0 0 0
0 0 0 0 0 0 0 0 0 0
0 0 0 0 0 0 0 0 0 0
