10 10
0 1 1 1 1 0 0 0 0 0
1 1 0 0 1 0 0 0 0 0
1 8 4 0 1 0 0 0 0 0 
1 1 4 0 1 1 0 0 0 0  
1 1 0 4 0 1 0 0 0 0
1 3 4 0 0 1 0 0 0 0
1 2 2 4 2 1 0 0 0 0  
1 1 1 1 1 1 0 0 0 0  
0 0 0 0 0 0 0 0 0 0 
0 0 0 0 0 0 0 0 0 0 